▣▣▣▣▣▣▣▣▣▣▣▣▣▣▣▣▣▣▣▣▣▣▣▣▣▣▣▣▣▣▣▣▣▣▣▣▣▣▣▣▣▣▣▣▣▣▣▣▣▣▣▣▣▣▣▣▣▣▣▣▣▣▣▣▣▣▣▣▣▣▣▣▣▣▣▣▣▣▣▣
▣♣            ▣▣             ▣                 ▣   ▣▣     ▣      ▣   ▣   ▣    ▣▣
▣   ▣▣▣▣                     ▣                           ▣▣                    ▣
▣   ▣▣▣▣                                                  ▣                    ▣
▣                            ▣             ♣              ▣                    ▣
▣♣♣♣                         ▣             ♣                      ⚑            ▣
▣♣♣♣♣    ▣▣▣▣▣▣▣▣            ▣                            ▣                    ▣
▣ ♣♣♣♣   ▣      ▣            ▣                            ▣                    ▣
▣  ♣     ▣      ▣            ▣                            ▣                    ▣
▣        ▣      ▣▣▣▣▣▣▣▣▣▣▣  ▣                            ▣                    ▣
▣   ☺♣   ▣                   ▣                            ▣                    ▣
▣        ▣                   ▣                            ▣                    ▣
▣        ▣▣▣▣▣▣▣▣▣▣▣▣▣▣▣▣▣▣▣▣▣                            ▣                    ▣
▣                            ▣                       ☠    ▣                    ▣
▣                  ♣         ▣                            ▣                    ▣
▣                            ▣                            ▣                    ▣
▣  ▣▣▣▣▣▣▣▣▣▣▣▣▣▣▣▣▣▣▣▣▣▣▣   ▣                            ▣                    ▣
▣  ▣                     ▣   ツ                            ▣                    ▣
▣  ▣                     ▣   ▣                            ▣                    ▣
▣  ▣                     ▣   ▣                            ▣▣▣▣▣▣▣▣▣▣▣▣▣▣▣▣▣▣▣▣ ▣
▣  ▣                     ▣▣▣▣▣                            ▣                    ▣
▣  ▣                         ▣                            ▣                    ▣
▣  ▣                         ▣                            ▣                    ▣
▣  ▣  ▣▣▣▣▣▣▣▣▣▣▣▣▣▣▣▣▣▣▣▣▣▣▣▣            ♣♣♣♣♣♣          ▣                    ▣
▣  ▣                       ⚷ ▣             ♣♣♣♣           ▣                    ▣
▣  ▣                         ▣                            ▣                    ▣
▣  ▣                         ▣                            ▣                    ▣
▣  ▣                         ▣                            ▣                    ▣
▣                            ▣                            ▣                    ▣
▣▣▣▣▣▣▣▣▣▣▣▣▣▣▣▣▣▣▣▣▣▣▣▣▣▣▣▣▣▣▣▣▣▣▣▣▣▣▣▣▣▣▣▣▣▣▣▣▣▣▣▣▣▣▣▣▣▣▣▣▣▣▣▣▣▣▣▣▣▣▣▣▣▣▣▣▣▣▣▣